1 1 1 1 1 1 1 1 1
1 5 0 8 1 y 5 l 1
1 b 1 0 1 1 2 1 1
1 5 1 4 1 0 0 0 1
1 a 1 4 1 0 1 4 1
1 5 1 d 5 a 1 4 1
1 0 1 1 1 1 1 0 1
1 7 0 4 4 4 0 5 1
1 1 1 1 1 1 1 1 1
