1 1 1 1 1 1 1 1 1
1 0 0 7 1 b 1 y 1
1 a 6 0 1 a 1 5 1
1 1 2 1 1 5 1 3 1
1 d 0 0 6 0 0 5 1
1 1 1 1 0 1 1 1 1
1 6 6 3 0 2 4 4 1
1 b 6 1 6 1 4 l 1
1 1 9 1 1 1 1 1 1
