1 1 1 1 1 1 1 1 1
1 0 0 2 0 0 0 y 1
1 y 0 1 1 2 1 1 1
1 1 1 1 0 4 3 t 1
1 s 4 0 0 0 1 1 1
1 3 1 1 1 0 6 y 1
1 0 0 d 1 4 5 4 1
1 8 0 a 1 4 b 4 1
1 1 1 1 1 1 1 1 1
